street name	stripped name
Abbey Rd	Abbey
Access Rd	Access
Accomac St	Accomac
Accommodation St	Accommodation
Acorn Ln	Acorn
Adler Rd	Adler
Admiral Gravely Blvd	Admiral Gravely
Admiral St	Admiral
Afton Ave	Afton
Agency Ave	Agency
Akron St	Akron
Alaska Dr	Alaska
Albany Ave	Albany
Albemarle Ave	Albemarle
Albemarle St	Albemarle
Alberene Rd	Alberene
Alder St	Alder
Alexander Ave	Alexander
Algoma St	Algoma
Allison St	Allison
Allwood Ave	Allwood
Alma Ave	Alma
Almond Ave	Almond
Alpine Ave	Alpine
Altamont Ave	Altamont
Althea Pkwy	Althea
Althea St	Althea
Alvis Ave	Alvis
Amanda Dr	Amanda
Amberly Rd	Amberly
Ambler St	Ambler
Ambrose St	Ambrose
Amelia St	Amelia
Amherst Ave	Amherst
Ammonett Dr	Ammonett
Ampthill Rd	Ampthill
Ander Ct	Ander
Andros Rd	Andros
Angela Dr	Angela
Angus Rd	Angus
Anne St	Anne
Anniston St	Anniston
Ansel St	Ansel
Antrim Ave	Antrim
Apache Ct	Apache
Apache Pl	Apache
Apache Rd	Apache
Apperson St	Apperson
Appomattox St	Appomattox
Aracoma Dr	Aracoma
Arcadia St	Arcadia
Archdale Rd	Archdale
Archer Ave	Archer
Arch St	Arch
Archwood Rd	Archwood
Ardendale Rd	Ardendale
Argall St	Argall
Argyle Ter	Argyle
Arizona Ct	Arizona
Arizona Dr	Arizona
Arizona Pl	Arizona
Arklow Rd	Arklow
Arlie St	Arlie
Arlington Rd	Arlington
Armfield Rd	Armfield
Arnold Ave	Arnold
Arnwood Rd	Arnwood
Arran Rd	Arran
Arrowhead Rd	Arrowhead
Ashby Way	Ashby
Ashdown Rd	Ashdown
Ashley Park	Ashley
Ashley St	Ashley
Atlantic Ave	Atlantic
Atmore Dr	Atmore
Atwell Dr	Atwell
Atwell Ln	Atwell
Augusta Ave	Augusta
Autumn Ln	Autumn
Avella Springs Ct	Avella Springs
Ave of Champions	of Champions
Avondale Ave	Avondale
Avonmore Rd	Avonmore
Avon Rd	Avon
Axtell St	Axtell
Azalea Ave	Azalea
Bailey St	Bailey
Bainbridge St	Bainbridge
Balding St	Balding
Balfour St	Balfour
Balsam Rd	Balsam
Banbury Rd	Banbury
Bancroft Ave	Bancroft
Bandy Rd	Bandy
Bangle Dr	Bangle
Bank St	Bank
Bannister Ln	Bannister
Banton St	Banton
Barcroft Ln	Barcroft
Barlen Dr	Barlen
Barningham Rd	Barningham
Baronet Dr	Baronet
Barriedale Rd	Barriedale
Barry St	Barry
Bartee Rd	Bartee
Barth Rd	Barth
Barton Ave	Barton
Bashford Ln	Bashford
Bassett Ave	Bassett
Bathgate Rd	Bathgate
Bathgate Ter	Bathgate
Bath St	Bath
Bathurst Rd	Bathurst
Baywood Ct	Baywood
Beattie St	Beattie
Beauchamp Ct	Beauchamp
Beaufont Ct	Beaufont
Beaufont Hills Ct	Beaufont Hills
Beaufont Hills Dr	Beaufont Hills
Beaufont Ter	Beaufont
Beaumont Ave	Beaumont
Beddington Rd	Beddington
Bedrock Ln	Bedrock
Beechmont Rd	Beechmont
Belfry Ct	Belfry
Bellemeade Rd	Bellemeade
Belleville St	Belleville
Bellevue Ave	Bellevue
Bellingham Ln	Bellingham
Bells Rd	Bells
Bells Rd Access Rd	Bells  Access Rd
Belmont Ct	Belmont
Belmont Rd	Belmont
Belt Blvd	Belt
Belt Blvd Exd	Belt
Bemiss Ct	Bemiss
Bemiss Rd	Bemiss
Berclair Ave	Berclair
Bergen Dr	Bergen
Berkley Ln	Berkley
Berkley Rd	Berkley
Berkshire Rd	Berkshire
Berrington Ct	Berrington
Berry Rd	Berry
Berry St	Berry
Berrywood Rd	Berrywood
Bertram Rd	Bertram
Berwick Rd	Berwick
Berwyn St	Berwyn
Bethany Dr	Bethany
Bethel St	Bethel
Bevridge Rd	Bevridge
Bewdley Rd	Bewdley
Bicknell Rd	Bicknell
Biggs Rd	Biggs
Bingham Dr	Bingham
Bingham Rd	Bingham
Binns Ave	Binns
Birch St	Birch
Birdwood Rd	Birdwood
Bittersweet Rd	Bittersweet
Blacker St	Blacker
Blackrock Dr	Blackrock
Blaine Rd	Blaine
Blair St	Blair
Blakemore Rd	Blakemore
Blakey St	Blakey
Bland St	Bland
Blandwood Rd	Blandwood
Blandy Ave	Blandy
Blanton Ave	Blanton
Blendwell Rd	Blendwell
Bliley Rd	Bliley
Blithewood Dr	Blithewood
Blue Ridge Ave	Blue Ridge
Blue Shingles Ln	Blue Shingles
Bluff Dr	Bluff
Boat Lake Dr	Boat
Boatwright Dr	Boatwright
Bolling Ave	Bolling
Bolton Rd	Bolton
Bondsor Ln	Bondsor
Bonmark Dr	Bonmark
Bonnington Ct	Bonnington
Bonnington Rd	Bonnington
Boroughbridge Rd	Boroughbridge
Boscobel Ave	Boscobel
Boston Ave	Boston
Bostwick Ln	Bostwick
Botetourt St	Botetourt
Boulder Creek Dr	Boulder Creek
Boulevard W	Boulevard
Bowen St	Bowen
Bowe St	Bowe
Bowland Rd	Bowland
Bowling Green Rd	Bowling
Boxley St	Boxley
Boyd St	Boyd
Boynton Pl	Boynton
Bradford Rd	Bradford
Bradley Ln	Bradley
Bradwill Rd	Bradwill
Brady St	Brady
Braeside Dr	Braeside
Bragg St	Bragg
Braidwood Rd	Braidwood
Brame St	Brame
Bramwell Rd	Bramwell
Branch Ave	Branch
Branchwood Dr	Branchwood
Brander St	Brander
Brandon Ln	Brandon
Brandon Rd	Brandon
Brauers Ln	Brauers
Breckenridge Rd	Breckenridge
Briarcliff Rd	Briarcliff
Briary Dr	Briary
Bridgeton Rd	Bridgeton
Briel St	Briel
Brinkwood Ct	Brinkwood
Brinkwood Dr	Brinkwood
Brinser St	Brinser
Brisbane Dr	Brisbane
Britannia Rd	Britannia
Brittwood Dr	Brittwood
Broach Dr	Broach
Broadingham Rd	Broadingham
Broad Rock Blvd	Broad
Broad Rock Rd	Broad
Brockenbrough Ln	Brockenbrough
Bromley Ln	Bromley
Brookbury Blvd	Brookbury
Brookfield St	Brookfield
Brookhaven Rd	Brookhaven
Brookhill Azalea Shopping Center	Brookhill Azalea Shopping Center
Brookland Pkwy	Brookland
Brookline St	Brookline
Brookside Rd	Brookside
Brownleaf Dr	Brownleaf
Brown St	Brown
Bruce St	Bruce
Bruton Rd	Bruton
Bryan Park Ave	Bryan
Bryan St	Bryan
Bryce Ln	Bryce
Buckhill Rd	Buckhill
Buckingham Ave	Buckingham
Buford Ave	Buford
Bulheller Rd	Bulheller
Bunche Pl	Bunche
Bundy Ave	Bundy
Bunn Ave	Bunn
Bunting Ave	Bunting
Burfoot St	Burfoot
Burgain Ct	Burgain
Burgain Rd	Burgain
Burgundy Rd	Burgundy
Burns St	Burns
Burrundie Dr	Burrundie
Burton St	Burton
Burtwood Ln	Burtwood
Bute Ln	Bute
Butte Rd	Butte
Byrd Park Ct	Byrd
Byron St	Byron
Byswick Ln	Byswick
Bywood Ln	Bywood
Cadosia Rd	Cadosia
Caldwell Ave	Caldwell
Caledonia Rd	Caledonia
Calhoun St	Calhoun
Call St	Call
Calumet Rd	Calumet
Calvert Dr	Calvert
Calverton St	Calverton
Calycanthus Rd	Calycanthus
Cambridge Rd	Cambridge
Cameo St	Cameo
Cameron St	Cameron
Campbell Ave	Campbell
Campus Dr	Campus
Canepa St	Canepa
Canterbury Rd	Canterbury
Capitol Sq	Capitol Sq
Capitol St	Capitol
Cargreen Rd	Cargreen
Carillon Ct	Carillon
Carlisle Ave	Carlisle
Carlton St	Carlton
Carmine St	Carmine
Carnaby Ct	Carnaby
Carnation St	Carnation
Carnation Street Con	Carnation Street Con
Carolina Ave	Carolina
Carriage Stone Ct	Carriage Stone
Carrie Ridge Ct	Carrie Ridge
Carrington St	Carrington
Carroll St	Carroll
Carrolton St	Carrolton
Carson St	Carson
Carter Creek Rd	Carter Creek
Carter Jones Park Priv	Carter Jones  Priv
Carter St	Carter
Carver St	Carver
Cary Ave	Cary
Cary Street Rd	Cary Street
Cashel Rd	Cashel
Caskie St	Caskie
Castleton Rd	Castleton
Castlewood Cir	Castlewood
Castlewood Rd	Castlewood
Catalina Dr	Catalina
Catalpa Ave	Catalpa
Cathedral Pl	Cathedral
Catherine Le	Catherine Le
Caulder Ct	Caulder
Cavalier Cir	Cavalier
Cecil Rd	Cecil
Cedar Grove Ct	Cedar Grove
Cedar Grove Rd	Cedar Grove
Cedarhurst Dr	Cedarhurst
Cedar Ln	Cedar
Cedar St	Cedar
Central Ave	Central
Cersley St	Cersley
Chalfont Dr	Chalfont
Chamberlayne Ave	Chamberlayne
Chamberlayne Pkwy	Chamberlayne
Chambers St	Chambers
Channing Cir	Channing
Channing Ln	Channing
Chantecler Ave	Chantecler
Chantilly St	Chantilly
Chapel Circle Rd	Chapel Circle
Chapel Dr	Chapel
Charles St	Charles
Charlevoix Ct	Charlevoix
Charlise Rd	Charlise
Charmian Rd	Charmian
Chase St	Chase
Chateau Dr	Chateau
Chatham Rd	Chatham
Chatsworth Dr	Chatsworth
Cheatham St	Cheatham
Cheatwood Ave	Cheatwood
Chellowe Rd	Chellowe
Chelsea St	Chelsea
Cherokee Rd	Cherokee
Chesco Rd	Chesco
Chesterfield Dr	Chesterfield
Chesterfield St	Chesterfield
Chesterman Ave	Chesterman
Chestnut St	Chestnut
Cheverly Rd	Cheverly
Chevy Chase St	Chevy Chase
Cheyenne Ct	Cheyenne
Cheyenne Rd	Cheyenne
Chicago Ave	Chicago
Chimborazo Blvd	Chimborazo
China St	China
Chippenham Pkwy	Chippenham
Chippenham Rd	Chippenham
Christopher la	Christopher la
Christopher Ln	Christopher
Chuckatuck Ave	Chuckatuck
Circlewood Dr	Circlewood
City Garage Priv	City Garage Priv
Claiborne St	Claiborne
Claremont Ave	Claremont
Clarence St	Clarence
Clarendon Dr	Clarendon
Clarke Rd	Clarke
Clarkson Ct	Clarkson
Clarkson Rd	Clarkson
Clayton Dr	Clayton
Clearfield St	Clearfield
Clemson Ave	Clemson
Cleveland St	Cleveland
Cliff Ave	Cliff
Clifton Ave	Clifton
Clinton Ave	Clinton
Clisby Rd	Clisby
Clovelly Rd	Clovelly
Clover Ln	Clover
Clydewood Ave	Clydewood
Coalter St	Coalter
Coastal Blvd	Coastal
Cofer Rd	Cofer
Colby Ln	Colby
Coles St	Coles
Collier Hill Rd	Collier
Collingbourne Rd	Collingbourne
Colorado Ave	Colorado
Columbia St	Columbia
Columbine Rd	Columbine
Comanche Dr	Comanche
Commerce Ct	Commerce
Commerce Rd	Commerce
Commerce Rd Acc	Commerce  Acc
Commonwealth Ave	Commonwealth
Concord Ave	Concord
Condie St	Condie
Confederate Ave	Confederate
Coniston Ave	Coniston
Conrad St	Conrad
Conway St	Conway
Cooks Rd	Cooks
Cool Ln	Cool
Cooper Rd	Cooper
Corbin St	Corbin
Co Rd 650	Co  
Cottingham Rd	Cottingham
Cottrell Rd	Cottrell
County Rd	County
Courtland St	Courtland
Court St	Court
Coventry Rd	Coventry
Covington Rd	Covington
Cowardin Ave	Cowardin
Crafton Ln	Crafton
Craigie Ave	Craigie
Crane St	Crane
Cranford Ave	Cranford
Creedmore St	Creedmore
Creek's Crossing Blvd	Creek' Crossing
Creek Summit Cir	Creek Summit
Creighton Rd	Creighton
Crenshaw Way	Crenshaw
Crestview Rd	Crestview
Crestwood Rd	Crestwood
Crieff Rd	Crieff
Croatan Rd	Croatan
Cronin Dr	Cronin
Cross Rd	Cross
Crumpton Ct N	Crumpton
Crumpton Dr	Crumpton
Crutchfield St	Crutchfield
Cullen Rd	Cullen
Cullenwood Dr	Cullenwood
Cullenwood Dr Exd	Cullenwood
Culpepper St	Culpepper
Culver Rd	Culver
Cumberland St	Cumberland
Cummings Dr	Cummings
Currie St	Currie
Custer St	Custer
Custis Rd	Custis
Cutshaw Ave	Cutshaw
Cypress St	Cypress
Dabney Rd	Dabney
Dakota Ave	Dakota
Dale Ave	Dale
Dallas Ave	Dallas
Dana St	Dana
Danbury Rd	Danbury
Dance St	Dance
Daniel St	Daniel
Darbytown Rd	Darbytown
Darden Rd	Darden
Darnley Dr	Darnley
Davee Rd	Davee
Dawn St	Dawn
Dawson Rd	Dawson
Daytona Dr	Daytona
Debora Dr	Debora
Decatur St	Decatur
Decker Rd	Decker
Deepwater Terminal Rd	Deepwater Terminal
Deerwood Rd	Deerwood
Deforrest St	Deforrest
Delano St	Delano
Delaware Ave	Delaware
Delivery Dr	Delivery
Delmont St	Delmont
Deloak Ave	Deloak
Denbigh Dr	Denbigh
Derrymore Ct	Derrymore
Derrymore Rd	Derrymore
Derwent Rd	Derwent
Deter Rd	Deter
Detroit Ave	Detroit
Devara Ct	Devara
Devonshire Ct	Devonshire
Devonshire Rd	Devonshire
Dill Ave	Dill
Dillwyn Rd	Dillwyn
Dinneen St	Dinneen
Dinwiddie Ave	Dinwiddie
Distributor Dr	Distributor
Ditchley Rd	Ditchley
Dixon Dr	Dixon
Dobson St	Dobson
Dock St	Dock
Domino Rd	Domino
Donnan St	Donnan
Dorchester Rd	Dorchester
Dorset Ct	Dorset
Dorset Rd	Dorset
Douglasdale Rd	Douglasdale
Doulton Rd	Doulton
Dover Rd	Dover
Dovershire Rd	Dovershire
Dove St	Dove
Downtown Expy	Downtown Expy
Drake St	Drake
Drewry St	Drewry
Drumheller Dr	Drumheller
Dubet Ln	Dubet
Dubois Ave	Dubois
Duffton Rd	Duffton
Dunbar St	Dunbar
Duncaster Rd	Duncaster
Dundee Ave	Dundee
Dunn Ave	Dunn
Dunston Ave	Dunston
Dupont Ave	Dupont
Dupont Cir	Dupont
Durham St	Durham
Duryea Ct	Duryea
Duryea Dr	Duryea
Duryea Pl	Duryea
Duval St Con	Duval  Con
Duval Street Con	Duval Street Con
Dylisdale Dr	Dylisdale
East Ave	East
Eastview Ln	Eastview
E Bacon St	Bacon
E Baker St	Baker
E Bates St	Bates
E Battery St	Battery
E Belt Blvd	Belt
E Blake Ln	Blake
E Broad Rock Rd	Broad
E Broad St	Broad
E Brookland Park Blvd	Brookland
E Byrd St	Byrd
E Canal St	Canal
E Cary St	Cary
E Charity St	Charity
Echo Ho Ln	Echo Ho
E Clay St	Clay
E Clopton St	Clopton
E Crawford Ave	Crawford
E Crawford St	Crawford
Eddystone Ct	Eddystone
Edgehill Rd	Edgehill
Edgemont Dr	Edgemont
Edgewood Ave	Edgewood
Edgewood Ln	Edgewood
E Duval St	Duval
Edwards Ave	Edwards
E Essex St	Essex
E Federal St	Federal
E Fells St	Fells
E Fells St Exd	Fells
Effingham Dr	Effingham
E Franklin St	Franklin
E German School Rd	German
Eggleston St	Eggleston
E Gladstone Ave	Gladstone
E Grace	Grace
E Grace St	Grace
E Graham Rd	Graham
E Hillcrest Ave	Hillcrest
E Home St	Home
E Hooper St	Hooper
E Hooper St Exd	Hooper
E Jackson St	Jackson
E Ladies Mile Rd	Ladies Mile
E Lancaster Rd	Lancaster
Elderslie Pl	Elderslie
E Leigh St	Leigh
Elgin Ter	Elgin
Elizabeth St	Elizabeth
Elkhardt Ln	Elkhardt
Elkhardt Rd	Elkhardt
Elkton Rd	Elkton
Ellen Rd	Ellen
Ellensview Cir	Ellensview
Ellensview Ct	Ellensview
Ellington St	Ellington
Ellis Woods Way	Ellis Woods
Ellsworth Rd	Ellsworth
Ellwood Ave	Ellwood
Elmbridge Rd	Elmbridge
Elmdale Ave	Elmdale
Elmore Ln	Elmore
Elmsmere Ave	Elmsmere
E Lock Ln	Lock
Elton St	Elton
E Main St	Main
E Marshall St	Marshall
E Martin's Grant Cir	Martin' Grant
E Meredith St	Meredith
Empearl Dr	Empearl
Endicott Rd	Endicott
Enfield Ave	Enfield
E Norwood Ave	Norwood
Enslow Ave	Enslow
E Pilkington St	Pilkington
Epperson Ave	Epperson
Eppington Rd	Eppington
E Preston St	Preston
Epsilon Rd	Epsilon
Erhart Rd	Erhart
Erich Ct	Erich
E Richmond Rd	Richmond
Erich Rd	Erich
Ernest Rd	Ernest
E Roanoke St	Roanoke
E Roberts St	Roberts
E Saunders Ave	Saunders
E Seminary Ave	Seminary
E Southside Plz	Southside Plz
Essex Pl	Essex
Eton Pl	Eton
E Treemont Ct	Treemont
E Tremont Ct	Tremont
Euclid Ave	Euclid
Evans St	Evans
Evansway Ln	Evansway
Evelyn Byrd Rd	Evelyn Byrd
Everett St	Everett
Everglades Dr	Everglades
Evergreen Ave	Evergreen
Evert Ave	Evert
Everview Rd	Everview
E Weyburn Rd	Weyburn
Exchange Aly	Exchange
Exeter Rd	Exeter
Exmouth Dr	Exmouth
Fairfax Ave	Fairfax
Fairfield Ave	Fairfield
Fairfield Way	Fairfield
Fairlee Rd	Fairlee
Fairmount Ave	Fairmount
Fairway View Rd	Fairway View
Falcon Rd	Falcon
Farrand St	Farrand
Fauquier Ave	Fauquier
Fawnbrook Blvd	Fawnbrook
Faye St	Faye
Felixstowe Dr	Felixstowe
Fells St	Fells
Fellsway Cir	Fellsway
Fellsway Rd	Fellsway
Felton Rd	Felton
Fendall Ave	Fendall
Fenton St	Fenton
Ferapont Dr	Ferapont
Fergerson Rd	Fergerson
Ferguson Ln	Ferguson
Fergusson Rd	Fergusson
Fernbrook Dr	Fernbrook
Fernbrook Pl	Fernbrook
Fernbrook Ter	Fernbrook
Ferncliff Rd	Ferncliff
Fernleigh Dr	Fernleigh
Fieldcrest Rd	Fieldcrest
Finchley Dr	Finchley
Finchley Pl	Finchley
Fitzhugh Ave	Fitzhugh
Fleming Rd	Fleming
Flint St	Flint
Floral Ave	Floral
Florida Ave	Florida
Floyd Ave	Floyd
Fluvanna Ave	Fluvanna
Fluvanna St	Fluvanna
Flynn Rd	Flynn
Folsom Rd	Folsom
Ford Ave	Ford
Forest Haven Dr	Haven
Forest Lawn Dr	Lawn
Forest View Dr	View
Forest View School Dr	View
Formex Rd	Formex
Forrest Hill Ave	Forrest
Forsythia St	Forsythia
Fourqurean Ln	Fourqurean
Frank Rd	Frank
Freeman Rd	Freeman
French St	French
Fritz St	Fritz
Frontier Dr	Frontier
Front St	Front
Fulton St	Fulton
Futura Ave	Futura
Gambles Mill Rd	Gambles Mill
Garber St	Garber
Garden Rd	Garden
Garfield Rd	Garfield
Garland Ave	Garland
Garrett St	Garrett
Gateway Rd	Gateway
Gavan Ave	Gavan
Gavestone Ct	Gavestone
Geneva Ct	Geneva
Geneva Dr	Geneva
Georgia Ave	Georgia
Germain Rd	Germain
German School Cres	German  Cres
German School Rd	German
Giant Dr	Giant
Gilbert St	Gilbert
Giles Ave	Giles
Gilliam St	Gilliam
Gilmer St	Gilmer
Gilmour Court Way	Gilmour Court
Givens Ct	Givens
Glasgow St	Glasgow
Glebe Close	Glebe Close
Glenan Dr	Glenan
Glenbeigh Dr	Glenbeigh
Glenburnie Rd	Glenburnie
Glencove Ln	Glencove
Glendye Rd	Glendye
Glenfield Ave	Glenfield
Glenlea Ave	Glenlea
Glenway Ct	Glenway
Glenway Dr	Glenway
Glenwood Ave	Glenwood
Gloucester Rd	Gloucester
Glyndon Ln	Glyndon
Goddin Cir	Goddin
Goddin Ct	Goddin
Goddin St	Goddin
Goodes St	Goodes
Goodwood Ct	Goodwood
Goodwood Rd	Goodwood
Gordon Ave	Gordon
Goshen St	Goshen
Government Rd	Government
Governor St	Governor
Granby St	Granby
Grand Brook Ct	Grand
Grand Brook Dr	Grand
Grandel Dr	Grandel
Grandview Dr	Grandview
Grandway Rd	Grandway
Granite Ave	Granite
Granite Hall Ave	Granite Hall
Granite Hill Cir	Granite
Grantlake Rd	Grantlake
Grantland Dr	Grantland
Grant St	Grant
Grantwood Ct	Grantwood
Grantwood Rd	Grantwood
Grantwood St	Grantwood
Gravel Hill Rd	Gravel
Grayland Ave	Grayland
Grayson St	Grayson
Gray St	Gray
Green Acres Ave	Acres
Greenbank Rd	Greenbank
Greenbay Rd	Greenbay
Green Cove Dr	Cove
Greenleaf Ln	Greenleaf
Greenmoss Dr	Greenmoss
Green Ridge Dr	Ridge
Greenvale Ct	Greenvale
Greenvale Dr	Greenvale
Greenville Ave	Greenville
Greenway Ln	Greenway
Greenwood Ave	Greenwood
Greer Ave	Greer
Gregory Ave	Gregory
Greshamwood Pl	Greshamwood
Grey Birch Dr	Grey Birch
Greycourt Ave	Greycourt
Greystone Ave	Greystone
Griffin Ave	Griffin
Griffin French Aly	Griffin French
Grimsby Rd	Grimsby
Gross Ave	Gross
Grove Ave	Grove
Groveland Ave	Groveland
Grubbs Ln	Grubbs
Guilder Ln	Guilder
Gun Club Rd	Gun Club
Gunn St	Gunn
Guthrie Ave	Guthrie
Gwynnbrook Rd	Gwynnbrook
Haden Ave	Haden
Hagueman Dr	Hagueman
Haig St	Haig
Halesworth Rd	Halesworth
Halifax Ave	Halifax
Halsey Ln	Halsey
Halstead Rd	Halstead
Hammond Ave	Hammond
Hampstead Ave	Hampstead
Hampton Commons Ter	Hampton Commons
Hampton Hills Ln	Hampton Hills
Hampton St	Hampton
Handy Ln	Handy
Hanes Ave	Hanes
Hanover Ave	Hanover
Hansdale Rd	Hansdale
Hardy St	Hardy
Hargrove St	Hargrove
Harlan Cir	Harlan
Harold Ave	Harold
Harrods Ln	Harrods
Harrow Pl	Harrow
Harrow Rd	Harrow
Harwood St	Harwood
Hastings Dr	Hastings
Hatcher St	Hatcher
Hathaway Rd	Hathaway
Haworth Rd	Haworth
Hawthorne Ave	Hawthorne
Haxall Pt	Haxall Pt
Hayden Hill Ln	Hayden
Hayes St	Hayes
Hazelhurst Ave	Hazelhurst
Heartwood Rd	Heartwood
Heath Ave	Heath
Heflin St	Heflin
Helen Ln	Helen
Henrico Blvd	Henrico
Henrico Dr	Henrico
Henri Rd	Henri
Herbert St	Herbert
Hermitage Rd	Hermitage
Heywood Rd	Heywood
Hickory Rd	Hickory
Hickory St	Hickory
Hiden Rd	Hiden
Highland St	Highland
Highland View Ave	Highland View
High Point Ave	High Point
High St	High
Hildreth St	Hildreth
Hileah Ave	Hileah
Hillcrest Ave	Hillcrest
Hillcrest Cir	Hillcrest
Hillcrest Rd	Hillcrest
Hill Monument Pkwy	Monument
Hilltop Dr	Hilltop
Hillwood Ave	Hillwood
Hillwood Rd	Hillwood
Hioaks Rd	Hioaks
Hobbs Ln	Hobbs
Hobby Hill Rd	Hobby
Hodges Rd	Hodges
Holbein Pl	Holbein
Holcombe Rd	Holcombe
Holdcroft Dr	Holdcroft
Holliday Rd	Holliday
Hollister Ave	Hollister
Holly Ln	Holly
Holly Spring Ave	Holly Spring
Holly St	Holly
Honaker Ave	Honaker
Hopkins Ct	Hopkins
Hopkins Ln	Hopkins
Hopkins Rd	Hopkins
Horner Ln	Horner
Horne St	Horne
Hospital St	Hospital
Houston Ave	Houston
Howard Rd	Howard
Huguenot Rd	Huguenot
Hull St	Hull
Hull St Rd Ser Dr	Hull   Ser
Hull Street Rd	Hull Street
Hunt Ave	Hunt
Hunter Holmes Dr	Hunter Holmes
Huntland Rd	Huntland
Huntley Rd	Huntley
Huth Rd	Huth
Huxley St	Huxley
H Whiting Cir	H Whiting
Idlewood Ave	Idlewood
Idlewyld Rd	Idlewyld
Ilex Ave	Ilex
Industry Ave	Industry
Ingalls Dr	Ingalls
Ingelnook Ct	Ingelnook
Inglenook Ct	Inglenook
Ingram Ave	Ingram
Irby Dr	Irby
Iris Ln	Iris
Iron Bridge Rd	Iron Bridge
Irvington St	Irvington
Ivanhoe St	Ivanhoe
Ivymount Rd	Ivymount
Jacquelin Ct	Jacquelin
Jacquelin St	Jacquelin
Jahnke Rd	Jahnke
James Falls Dr	James Falls
James Riverwatch Dr	James Riverwatch
Jamestown Ave	Jamestown
Janet Way	Janet
Jarvis Rd	Jarvis
Jasonwood Ct	Jasonwood
Jasper Ave	Jasper
Jefferson Ave	Jefferson
Jefferson Davis Hwy	Jefferson Davis
Jefferson Village Dr	Jefferson Village
Jennie Scher Rd	Jennie Scher
Jervie Dr	Jervie
Jessamine St	Jessamine
Jeter Ave	Jeter
John Christopher Ct	John Christopher
Joplin Ave	Joplin
Judah St	Judah
Judson Rd	Judson
Junaluska Cir	Junaluska
Junaluska Ct	Junaluska
June Dr	June
Juniper St	Juniper
Kaki Dr	Kaki
Kalimat Ln	Kalimat
Kane St	Kane
Kansas Ave	Kansas
Keaneland Dr	Keaneland
Keichtee Dr	Keichtee
Keighly Rd	Keighly
Keller Rd	Keller
Kelly Rd	Kelly
Kelnor Ave	Kelnor
Kelrae Dr	Kelrae
Kelso Rd	Kelso
Kemper St	Kemper
Kenbury Ct	Kenbury
Kenbury Rd	Kenbury
Kendall Rd	Kendall
Kenmore Cir	Kenmore
Kenmore Rd	Kenmore
Kennondale Ln	Kennondale
Kensington Ave	Kensington
Kent Rd	Kent
Kenyon Ave	Kenyon
Kern St	Kern
Keswick Ave	Keswick
Keswick Ln	Keswick
Keuka Rd	Keuka
Kildare Dr	Kildare
Kimberly Cir	Kimberly
Kimberly Dr	Kimberly
Kimrod Rd	Kimrod
Kingcrest Pkwy	Kingcrest
Kingsbury Rd	Kingsbury
King St	King
Kingsway Ct	Kingsway
Kingsway Rd	Kingsway
Kingswood St	Kingswood
King William Rd	King William
Kinney St	Kinney
Kinsley Ave	Kinsley
Kirby Rd	Kirby
Kittering Dr	Kittering
Klondike Rd	Klondike
Knob Rd	Knob
Kristenleaf Ct	Kristenleaf
Krouse St	Krouse
Kuhn St	Kuhn
Labrook Concourse	Labrook Concourse
Labrook Dr	Labrook
Lacorolla Ave	Lacorolla
Ladbroke Ct	Ladbroke
Lady St	Lady
Lafayette St	Lafayette
Lakeshire Ct	Lakeshire
Lake Terrace Ct	Terrace
Lakeview Ave	Lakeview
Lakeview Ln	Lakeview
Lake Village Dr	Village
Lamar Dr	Lamar
Lamb Ave	Lamb
Lamberts Ave	Lamberts
Lambeth Rd	Lambeth
Lamesa Dr	Lamesa
Lamont St	Lamont
Lancelot Ave	Lancelot
Landria Dr	Landria
Laneview Dr	Laneview
Lanewood Dr	Lanewood
Langdon Ct	Langdon
Langdon Dr	Langdon
Langston Ave	Langston
Lansdale Rd	Lansdale
Lansing Ave	Lansing
Lanvale Ave	Lanvale
Laporte Rd	Laporte
Larchmont Ln	Larchmont
Larne Ave	Larne
Larne Rd	Larne
Larrymore Ct	Larrymore
Larrymore Rd	Larrymore
Larus Ct	Larus
Lasalle Dr	Lasalle
Lauradale Ln	Lauradale
Lauradale Ln Con	Lauradale  Con
Laurelbrook Dr	Laurelbrook
Laurel Fork Dr	Laurel Fork
Laveta Dr	Laveta
Lawson St	Lawson
Leake Ave	Leake
Lebanon St	Lebanon
Legion Ave	Legion
Leicester Rd	Leicester
Leigh Street Viaduct	Leigh Street Viaduct
Lenmore St	Lenmore
Leonard Pkwy	Leonard
Letcher Ave	Letcher
Lethbridge Rd	Lethbridge
Levering Ln	Levering
Lewis Ave	Lewis
Lexington Rd	Lexington
Libbie Ave	Libbie
Libby Ter	Libby
Lilac Ln	Lilac
Limerick Dr	Limerick
Limestone Dr	Limestone
Lincoln Aly	Lincoln
Lincoln Ave	Lincoln
Linden Ln	Linden
Lindlaw Ave	Lindlaw
Lindy Ln	Lindy
Linwood Ave	Linwood
Lipscomb St	Lipscomb
Lipton Rd	Lipton
Lisson Cres	Lisson Cres
Little John Rd	Little John
Littlepage St	Littlepage
Lochaven Ave	Lochaven
Lochaven Blvd	Lochaven
Lochinvar Dr	Lochinvar
Loch Lomond Ct	Loch Lomond
Loch Lomond Ln	Loch Lomond
Lockgreen Cir	Lockgreen
Lockgreen Ct	Lockgreen
Lockgreen Pl	Lockgreen
Lodge St	Lodge
Logandale Ave	Logandale
Lombardy Aly	Lombardy
Lombardy Pl	Lombardy
Lone St	Lone
Long Ln	Long
Longview Ct	Longview
Longview Dr	Longview
Lookout Dr	Lookout
Lordley Ln	Lordley
Lordley Rd	Lordley
Lorieville Ln	Lorieville
Lorraine Ave	Lorraine
Lost Ln	Lost
Loudon St	Loudon
Louisiana St	Louisiana
Loumour Ave	Loumour
Lovells Rd	Lovells
Lowry St	Lowry
Loxley Rd	Loxley
Lucinda Ln	Lucinda
Ludwig Rd	Ludwig
Lumkin Ave	Lumkin
Lunenburg St	Lunenburg
Luray Ave	Luray
Luton Ln	Luton
L Walker Pl	L Walker
Lynhaven Ave	Lynhaven
Lynton Ln	Lynton
Macarthur Ave	Macarthur
Mactavish Ave	Mactavish
Maddox St	Maddox
Maggie Walker Ave	Maggie Walker
Magnolia Ct	Magnolia
Magnolia Rd	Magnolia
Magnolia St	Magnolia
Major Ginter Ct	Major Ginter
Malone St	Malone
Malvern Ave	Malvern
Manchester Rd	Manchester
Mandalay Dr	Mandalay
Mandy Ln	Mandy
Manorcrest Rd	Manorcrest
Mansion Ave	Mansion
Maple Ave	Maple
Maple Shade Ln	Maple Shade
Maplestead Ln	Maplestead
Maplested Ln	Maplested
Maplewood Ave	Maplewood
Marcy Pl	Marcy
Mardick Rd	Mardick
Marganne Ct	Marganne
Margate Dr	Margate
Margrave Ave	Margrave
Marian St	Marian
Marilea Rd	Marilea
Marion Mashore St	Marion Mashore
Mark Rd	Mark
Marlboro Ct	Marlboro
Marlboro Dr	Marlboro
Marlowe Rd	Marlowe
Marston Ln	Marston
Martha Ln	Martha
Martin's Grant Dr	Martin' Grant
Marx St	Marx
Marybrooks Ct	Marybrooks
Marybrooks Ln	Marybrooks
Maryland Ave	Maryland
Mary View Dr	Mary View
Mason St	Mason
Massie Rd	Massie
Mast Dr	Mast
Mastin Ln	Mastin
Matisse Ln	Matisse
Matoaka Rd	Matoaka
Matthews St	Matthews
Maurice Ave	Maurice
Maury St	Maury
Maverick Ave	Maverick
Maxwell Rd	Maxwell
Mayfair Ave	Mayfair
Mayhew St	Mayhew
Maywill St	Maywill
McCloy St	McCloy
McDonough St	McDonough
McDowell Rd	McDowell
McGuire Cir	McGuire
McGuire Dr	McGuire
McKay Ave	McKay
McLennan St	McLennan
McLeod Rd	McLeod
McRand St	McRand
Meade St	Meade
Meadowbridge Rd	Meadowbridge
Mechanicsville Tpke	Mechanicsville Tpke
Mecklenburg St	Mecklenburg
Media Rd	Media
Meeks Ln	Meeks
Melbourne Dr	Melbourne
Melbourne St	Melbourne
Melmark Ct	Melmark
Melmark Rd	Melmark
Melrose Ave	Melrose
Melton Ave	Melton
Menokin Rd	Menokin
Meridale Rd	Meridale
Meridian Ave	Meridian
Merrifield Dr	Merrifield
Merrigan Rd	Merrigan
Merrimac Rd	Merrimac
Merry Oaks Ave	Merry Oaks
Mervine Rd	Mervine
Middlesex St	Middlesex
Midland St	Midland
Midlothian Tpke	Midlothian Tpke
Mike Rd	Mike
Millenbeck Rd	Millenbeck
Miller Ave	Miller
Milton St	Milton
Mimosa St	Mimosa
Minefee St	Minefee
Minor St	Minor
Missouri Ave	Missouri
Mitchell St	Mitchell
Mobile Rd	Mobile
Mobil Rd	Mobil
Monet Ct	Monet
Monitor Rd	Monitor
Monroe Aly	Monroe
Montague Rd	Montague
Montauk Dr	Montauk
Montebello Cir	Montebello
Montecrest Ave	Montecrest
Monteiro Ave	Monteiro
Monteiro St	Monteiro
Monteith Rd	Monteith
Montford Ave	Montford
Montgomery St	Montgomery
Monticello St	Monticello
Montpelier St	Montpelier
Montrose Ave	Montrose
Montvale Ave	Montvale
Monumental St	Monumental
Monument Ave	Monument
Monument Park	Monument
Moody Ave	Moody
Moore St	Moore
Mosby St	Mosby
Moss Side Ave	Moss Side
Mount Erin Dr	Mount Erin
Mount Vernon St	Mount Vernon
Mowbray Ave	Mowbray
Mozelle St	Mozelle
Munford St	Munford
Murchies Hill Rd	Murchies
Myers St	Myers
Myers St N	Myers
Myrtle St	Myrtle
N Adams St	Adams
N Allen Ave	Allen
N Allison St	Allison
Napoleon St	Napoleon
Napotnic Ln	Napotnic
Narbeth Ave	Narbeth
N Ashlawn Dr	Ashlawn
National St	National
N Auburn Ave	Auburn
Navaho Rd	Navaho
Navarone Ave	Navarone
Navy Hill Dr	Navy
N Belmont Ave	Belmont
N Belvidere St	Belvidere
N Brunswick St	Brunswick
N Cathedral Pl	Cathedral
N Cherry St	Cherry
N Cleveland St	Cleveland
N Colonial Ave	Colonial
N Crenshaw Ave	Crenshaw
N Davis Ave	Davis
N Dooley Ave	Dooley
Nelson St	Nelson
Nelwood Dr	Nelwood
Nestle Ave	Nestle
Netherwood Rd	Netherwood
Nevada Ave	Nevada
Newbourne St	Newbourne
Newbury Ave	Newbury
Newell Rd	Newell
New Fraternity Row	New Fraternity Row
Newhaven Dr	Newhaven
New Kent Ave	New Kent
New Kent Rd	New Kent
Newkirk Dr	Newkirk
Newman Rd	Newman
Newman Village	Newman Village
Newport Dr	Newport
Newton Rd	Newton
New York Ave	New York
N Foushee St	Foushee
N Granby St	Granby
N Grand Brook Cir	Grand
N Hamilton St	Hamilton
N Hancock St	Hancock
N Harrison St	Harrison
N Harvie St	Harvie
N Henry St	Henry
N Hopkins Rd	Hopkins
N Huguenot Rd	Huguenot
Nicholson St	Nicholson
Nicolet Cir	Nicolet
Nicolet Rd	Nicolet
Nine Mile Rd	Nine Mile
N Jefferson St	Jefferson
N Junaluska Dr	Junaluska
N Laurel St	Laurel
N Linden St	Linden
N Lombardy St	Lombardy
N Madison St	Madison
N Meadow St	Meadow
N Monroe St	Monroe
N Morris St	Morris
N Mulberry St	Mulberry
N Nansemond St	Nansemond
Noble Ave	Noble
Nokomis Rd	Nokomis
Norborne Rd	Norborne
Norcroft Cir	Norcroft
Norcroft Dr	Norcroft
Norcroft Ter	Norcroft
Norcross Rd	Norcross
Norfolk St	Norfolk
Northampton St	Northampton
North Ave	North
Northridge Ct	Northridge
Northridge Rd	Northridge
Northrop St	Northrop
Northside Ave	Northside
Northumberland Ave	Northumberland
Northview Pl	Northview
Norton St	Norton
Norwood Ct	Norwood
Nottingham Pl	Nottingham
Nottingham Rd	Nottingham
Nottoway Ave	Nottoway
N Plum St	Plum
N Riverside Dr	Riverside
N Robinson St	Robinson
N Rowland St	Rowland
N Sheppard St	Sheppard
N Shields Ave	Shields
N Stafford Ave	Stafford
N Thompson St	Thompson
N Tilden St	Tilden
Nutmeg Ct	Nutmeg
N Vine St	Vine
N Willetta Dr	Willetta
N Wilton Rd	Wilton
Oakdale Ave	Oakdale
Oak Glen St	Glen
Oakhurst Ln	Oakhurst
Oakhurst Rd	Oakhurst
Oakland Ave	Oakland
Oakland Pl	Oakland
Oakleaf Rd	Oakleaf
Oakwood Ave	Oakwood
Oberlin Rd	Oberlin
Ohio St	Ohio
Old Canal Rd	Canal
Old Carnation St	Carnation
Old Denny St	Denny
Old Dominion St	Dominion
Olde Lock Ln	Olde Lock
Oldfield Dr	Oldfield
Old Fraternity Row	Fraternity Row
Old Gun Trce	Gun Trce
Oldham Ct	Oldham
Oldham Rd	Oldham
Old Holly Rd	Holly
Old Hopkins Rd	Hopkins
Old Jahnke Rd	Jahnke
Old Locke Ln	Locke
Old Lock Ln	Lock
Old Main St	Main
Old Midlothian Tpke	Midlothian Tpke
Old Mill Rd	Mill
Old Nicholson St	Nicholson
Old Orchard Ln	Orchard
Old Orchard Rd	Orchard
Old Post Rd	Post
Old Quarry Rd	Quarry
Old Spring Rd	Spring
Old Warwick Rd	Warwick
Old Westham Rd	Westham
Olive Ave	Olive
Oliver Hill Way	Oliver
Orchard Rd	Orchard
Orcutt Ln	Orcutt
Ordway Ave	Ordway
Oregon Hill Pkwy	Oregon
Orlando Rd	Orlando
Orleans St	Orleans
Osoge Rd	Osoge
Ottawa Rd	Ottawa
Overbrook Rd	Overbrook
Overlook St	Overlook
Ownby Ln	Ownby
Oxford Cir	Oxford
Oxford Cir E	Oxford
Oxford Cir W	Oxford
Oxford Pkwy	Oxford
Oxford Rd	Oxford
Paddle Boat Ln	Paddle Boat
Palmyra Ave	Palmyra
Pamworth Ln	Pamworth
Parker St	Parker
Parkwood Ave	Parkwood
Parrish St	Parrish
Patrick Ave	Patrick
Patsy Ann Dr	Patsy Ann
Patterson Ave	Patterson
Pauls Ln	Pauls
Pawnee Rd	Pawnee
Paxton Rd	Paxton
Pear St	Pear
Pebble Ct	Pebble
Pelham Dr	Pelham
Pember Ln	Pember
Pennsylvania Ave	Pennsylvania
Penrose Dr	Penrose
Pensacola Ave	Pensacola
Penshurst Rd	Penshurst
Pepper Ave	Pepper
Perdue Ave	Perdue
Perry St	Perry
Peterborough Rd	Peterborough
Peter Paul Blvd	Peter Paul
Petoskey Ave	Petoskey
Pettus Rd	Pettus
Peyton Ave	Peyton
Phaup St	Phaup
Phillip Morris Drive Way	Phillip Morris Drive
Pierpont Rd	Pierpont
Pilots Ln	Pilots
Pinebrook Dr	Pinebrook
Pine Crest Ave	Crest
Pine Ridge Rd	Ridge
Pineway Dr	Pineway
Piney Branch Rd	Piney Branch
Piney Rd	Piney
Pink St	Pink
Pittaway Dr	Pittaway
Pitt St	Pitt
Plainfield Rd	Plainfield
Platinum Rd	Platinum
Playn St	Playn
Plazaview Rd	Plazaview
Plotkin Rd	Plotkin
Plymouth Dr	Plymouth
Pocahontas Ave	Pocahontas
Pocosham Dr	Pocosham
Pollock St	Pollock
Pompey Spring Rd	Pompey Spring
Pondera Rd	Pondera
Pope Ave	Pope
Poplar Ln	Poplar
Porter St	Porter
Portland Pl	Portland
Potomac St	Potomac
Potters Ct	Potters
Powell Rd	Powell
Powhatan Ave	Powhatan
Powhatan St	Powhatan
Powhite Pkwy	Powhite
Poyntelle Rd	Poyntelle
Prairie Rd	Prairie
Pratt St	Pratt
Prentis St	Prentis
Presson Blvd	Presson
Price St	Price
Pride Rd	Pride
Primrose Pl	Primrose
Primrose Pl Ser Dr	Primrose  Ser
Prince Arthur Rd	Prince Arthur
Prince Edward Rd	Prince Edward
Prince George Rd	Prince George
Prince Hall Dr	Prince Hall
Princess Anne Ave	Princess Anne
Princeton Rd	Princeton
Priv	Priv
Prospect Rd	Prospect
Prospect St	Prospect
Pulaski St	Pulaski
Pulliam St	Pulliam
Pump House Dr	Pump House
Purcell St	Purcell
Pusey Ln	Pusey
Queen Anne Dr	Queen Anne
Queen Charlotte Rd	Queen Charlotte
Queensbury Rd	Queensbury
Quicksall Ln	Quicksall
Radford Ave	Radford
Rady St	Rady
Ragsdale Rd	Ragsdale
Ralph Blvd	Ralph
Rams Vw	Rams Vw
Randall Ave	Randall
Randolph St	Randolph
Raven St	Raven
Rawlings St	Rawlings
Rebecca Rd	Rebecca
Red Ash Dr	Red Ash
Redd St	Redd
Redwood Ave	Redwood
Reedy Ave	Reedy
Regent Cir	Regent
Register Pkwy	Register
Rendale Ave	Rendale
Rennie Ave	Rennie
Republic Dr	Republic
Reserve St	Reserve
Reservoir Ln	Reservoir
Rettig Rd	Rettig
Reveille St	Reveille
Rhoadmiller St	Rhoadmiller
Rhodes Ave	Rhodes
Rice Rd	Rice
Richdale Rd	Richdale
Richeson Ave	Richeson
Richmond Henrico Tpke	Richmond Henrico Tpke
Richmond-Petersburg Tpke	Richmond-Petersburg Tpke
Richmond St	Richmond
Richmond Way	Richmond
Ridgecliff Dr	Ridgecliff
Ridgemont Rd	Ridgemont
Ridgeway Rd	Ridgeway
Rio Vista Ln	Rio Vista
Ripley Ave	Ripley
Ritter St	Ritter
Rivanna Dr	Rivanna
River City Court Way	River City Court
Rivercrest Rd	Rivercrest
River Rd	River
Riverside Dr	Riverside
Riverside Park	Riverside
Riverview Dr	Riverview
Riverview Pkwy	Riverview
Roane St	Roane
Roberson Ln	Roberson
Robert Bruce Dr	Robert Bruce
Robert E Lee Brg	Robert  Lee Brg
Robert Moore Cir	Robert Moore
Roberts St	Roberts
Robin Hood Rd	Robin Hood
Robin Rd	Robin
Robinview Dr	Robinview
Rockbridge St	Rockbridge
Rockfalls Dr	Rockfalls
Rockland Rd	Rockland
Rodman Rd	Rodman
Rogers St	Rogers
Rolfe Rd	Rolfe
Rosanell Ln	Rosanell
Rose Ave	Rose
Rosecrest Ave	Rosecrest
Rosedale Ave	Rosedale
Roselawn Rd	Roselawn
Rosemont Rd	Rosemont
Roseneath Rd	Roseneath
Rosetta St	Rosetta
Rosewell Ct	Rosewell
Rosewood Ave	Rosewood
Roslyn Rd	Roslyn
Rossmore Rd	Rossmore
Rothesay Cir	Rothesay
Rothesay Rd	Rothesay
Rowen Ave	Rowen
Rowe St	Rowe
Roxbury Rd	Roxbury
Royall Ave	Royall
Rubimont Rd	Rubimont
Rucker Ct	Rucker
Rucker Ln	Rucker
Rueger St	Rueger
Ruffin Rd	Ruffin
Rugby Rd	Rugby
Rusk Ave	Rusk
Rusk Ct	Rusk
Russell St	Russell
Rustic Rd	Rustic
Rutherford Rd	Rutherford
Ryburn Rd	Ryburn
Ryland St	Ryland
Sabot St	Sabot
S Adams St	Adams
S Addison St	Addison
Saddleback Dr	Saddleback
Saint Ann's Dr	Saint Ann'
Saint Moritz Ct	Saint Moritz
Saint Moritz Dr	Saint Moritz
Salem St	Salem
Sale St	Sale
Saline Dr	Saline
S Allen Ave	Allen
Sanborn Dr	Sanborn
Sara Ln	Sara
Saratoga Rd	Saratoga
S Ashlawn Dr	Ashlawn
S Auburn Ave	Auburn
Sauer Ave	Sauer
Saunders Ave	Saunders
Sawston Rd	Sawston
S Beech St	Beech
S Belmont Ave	Belmont
S Belmont Rd	Belmont
S Belvidere St	Belvidere
S Brunswick St	Brunswick
Scarsborough Dr	Scarsborough
S Cathedral Pl	Cathedral
S Cherry St	Cherry
S Cherry St Exd	Cherry
Schloss Rd	Schloss
Schutte Ave	Schutte
Scl RR Spur Rd	Scl RR Spur
S Coleman Ln	Coleman
S Colonial Ave	Colonial
Scottdale St	Scottdale
Scott St	Scott
Scottview Dr	Scottview
S Crenshaw Ave	Crenshaw
S Davis Ave	Davis
S Dooley Ave	Dooley
Seaman Rd	Seaman
Seddon Rd	Seddon
Seddon Way	Seddon
Selden St	Selden
Seminary Ave	Seminary
Seminary Pl	Seminary
Semmes Ave	Semmes
Seneca Rd	Seneca
Sequoyah Rd	Sequoyah
Service Rd	Service
Sewell St	Sewell
S Foushee St	Foushee
S German School Rd	German
S Granby St	Granby
S Grand Brook Cir	Grand
Shackleford Rd	Shackleford
Shadwell Rd	Shadwell
Shadybrook Ln	Shadybrook
Shafer St	Shafer
Shallow Ct	Shallow
Shallow Way	Shallow
S Hamilton St	Hamilton
Sharon Ct	Sharon
S Harrison St	Harrison
S Harvie St	Harvie
Shaw Ln	Shaw
Shawnee Rd	Shawnee
Sheffield Rd	Sheffield
Sheila Ln	Sheila
Shelby Dr	Shelby
Shenandoah St	Shenandoah
Sherbrook Rd	Sherbrook
Sheridan Ln	Sheridan
Sherwood Ave	Sherwood
Shields Ave	Shields
Shields Lake Ct	Shields
Shields Lake Dr	Shields
Shirley Ln	Shirley
Shirley Rd	Shirley
Shockoe Slip	Shockoe Slip
Shore Dr	Shore
Shoreham Dr	Shoreham
Short Decatur St	Short Decatur
Short St	Short
Silbury Rd	Silbury
Silver Ave	Silver
Silverwood Dr	Silverwood
Simpson Ave	Simpson
Sioux Rd	Sioux
Sisco Ave	Sisco
S Jefferson St	Jefferson
S Kenmore Rd	Kenmore
Skilift Ct	Skilift
Skilift Ln	Skilift
S Kinsley Ave	Kinsley
Skipping Rock Ct	Skipping
Skipping Rock Ln	Skipping
Skipping Rock Pl	Skipping
Skipping Rock Way	Skipping
Skipton Rd	Skipton
S Laurel St	Laurel
Sledd St	Sledd
S Linden St	Linden
S Linden St Exd	Linden
S Locke Ln	Locke
S Lock Ln	Lock
S Lombardy St	Lombardy
S Madison St	Madison
S Meadow St	Meadow
Smithdeal Ave	Smithdeal
Smith St	Smith
S Morris St	Morris
S Mulberry St	Mulberry
S Nansemond St	Nansemond
Snead Ct	Snead
Snead Rd	Snead
Snowden Ln	Snowden
Somerset Ave	Somerset
Souder Ct	Souder
Southall Ave	Southall
Southampton Ave	Southampton
Southampton Rd	Southampton
Southaven Rd	Southaven
Southcliff Rd	Southcliff
South Dr	South
Southern Pine Ct	Southern
Southern Pine Dr	Southern
Southgate St	Southgate
Southlawn Ave	Southlawn
Southwood Pkwy	Southwood
Spaine St	Spaine
Spicer Rd	Spicer
Spider Ln	Spider
S Plum St	Plum
Spokane St	Spokane
Spotsylvania St	Spotsylvania
Spottswood Rd	Spottswood
Spring Grove Dr	Spring Grove
Springhill Ave	Springhill
Springhill Ln	Springhill
Springs Rd	Springs
Spring St	Spring
Springton Rd	Springton
Springview Dr	Springview
Spruance Rd	Spruance
Spruce St	Spruce
S Randolph St	Randolph
S Robinson St	Robinson
S Rowland St	Rowland
S Sheppard St	Sheppard
S Shields Ave	Shields
S Stafford Ave	Stafford
Stacie Rd	Stacie
St Andrews Cir	Andrews
St Andrews Ln	Andrews
Stanhope Ave	Stanhope
St Ann's Dr	Ann'
Stansbury Ave	Stansbury
Staples Mill Rd	Staples Mill
St Benedict Ln	Benedict
St Catherine's Ln	Catherine'
St Christopher's Rd	Christopher'
St Davids Ln	Davids
Stegge Ave	Stegge
Sterling St	Sterling
Sterncroft Dr	Sterncroft
S Thompson St	Thompson
Stiff St	Stiff
St James Ct	James
St James St	James St
St John St	John St
St John's Wood	John' Wood
St John's Wood Dr	John' Wood
St John's Wood Ser Dr	John' Wood Ser
Stockton Ln	Stockton
Stockton St	Stockton
Stockwood Rd	Stockwood
Stokes Ln	Stokes
Stonehurst Green	Stonehurst
Stonewall Ave	Stonewall
Stonybrook Dr	Stonybrook
Stony Crest Cir	Crest
Stony Point Pkwy	Point
Stony Point Rd	Point
Stowe Dr	Stowe
Stowmarket Ct	Stowmarket
St Paul St	Paul St
St Peter St	Peter St
Stratford Ave	Stratford
Stratford Cres	Stratford Cres
Stratford Ct	Stratford
Stratford Pl	Stratford
Stratford Rd	Stratford
Stratford Townes Dr	Stratford Townes
Stratford Townes Pl	Stratford Townes
Stratford Townes Way	Stratford Townes
Stratton Rd	Stratton
Strawberry St	Strawberry
Strollers Ln	Strollers
Stuart Ave	Stuart
Stuart Cir	Stuart
Suffolk Rd	Suffolk
Sugarbush Dr	Sugarbush
Sugar Maple Dr	Sugar Maple
Sulgrave Rd	Sulgrave
Summer Hill Ave	Summer
Summit Ave	Summit
Summit Ln	Summit
Sumpter St	Sumpter
Sunbury Rd	Sunbury
Sunlight Ave	Sunlight
Sunora Ct	Sunora
Sunora Dr	Sunora
Sunset Ave	Sunset
Sunset Ln	Sunset
Susan Dr	Susan
Sussex St	Sussex
Susten Ct	Susten
Susten Ln	Susten
S Vine St	Vine
Swan Lake Dr	Swan
Swansboro Ln	Swansboro
Swanson Rd	Swanson
Sweetwood Dr	Sweetwood
S Willetta Dr	Willetta
S Wilton Rd	Wilton
Sylvan Ct	Sylvan
Sylvan Rd	Sylvan
Talbert Dr	Talbert
Tanby Rd	Tanby
Tanglewood Rd	Tanglewood
Tapoan Pl	Tapoan
Tapoan Rd	Tapoan
Tarpley Rd	Tarpley
Tate St	Tate
Taylor Ave	Taylor
Tazewell St	Tazewell
Teakwood Ave	Teakwood
Temple St	Temple
Templeton Rd	Templeton
Tempsford Ln	Tempsford
Tennyson Ave	Tennyson
Terminal Ave	Terminal
Terminal Pl	Terminal
Texas Ave	Texas
Thaxton St	Thaxton
The Plaza	The Plaza
The Terrace	The Terrace
Thomas St	Thomas
Thorndale Ln	Thorndale
Three Chopt Rd	Three Chopt
Thurman St	Thurman
Tiber Ln	Tiber
Tiffany Cir	Tiffany
Tifton Ct	Tifton
Tignor Rd	Tignor
Tilden St	Tilden
Tilford Rd	Tilford
Tilton Ct	Tilton
Titan Dr	Titan
Titus St	Titus
Toby Rd	Toby
Toddsbury Rd	Toddsbury
Toledo Ave	Toledo
Tomacee Rd	Tomacee
Tompkins St	Tompkins
Tonbridge Rd	Tonbridge
Towana Rd	Towana
Tow Path Cir	Tow Path
Tow Path Ct	Tow Path
Tow Path Ln	Tow Path
Tow Path Ln S	Tow Path
Trabue Rd	Trabue
Trafford Rd	Trafford
Transport Pl	Transport
Transport St	Transport
Traylor Dr	Traylor
Tredegar St	Tredegar
Treehaven Dr	Treehaven
Trenton Ave	Trenton
Trevor Ter	Trevor
Trigg St	Trigg
Trinity High School	Trinity High
Troy Ct	Troy
Troy Rd	Troy
Tuckahoe Ave	Tuckahoe
Tuckahoe Blvd	Tuckahoe
Tulip St	Tulip
Turf Ln	Turf
Turpin St	Turpin
Tuskegee St	Tuskegee
Tutti Dr	Tutti
Tuxedo Blvd	Tuxedo
Twin Valley Rd	Twin Valley
Two Path Cir	Two Path
Twyman Rd	Twyman
Tybee Ter	Tybee
Tyler St	Tyler
Tynick St	Tynick
Tyrone St	Tyrone
Ullswater Ave	Ullswater
Union St	Union
Uppingham Ct	Uppingham
Uppingham Rd	Uppingham
Uppingham Ter	Uppingham
Utah Pl	Utah
Vaden Dr	Vaden
Vale St	Vale
Valley Rd	Valley
Venable St	Venable
Veranda Ave	Veranda
Vesper Rd	Vesper
Veterans Ave	Veterans
Vevadel Dr	Vevadel
Vial Rd	Vial
Victor St	Victor
Vinton St	Vinton
Virginia Ave	Virginia
Virginia St	Virginia
Virginia Way	Virginia
Vista St	Vista
Vivian Ct	Vivian
Waewick Rd Con	Waewick  Con
Wainfleet Dr	Wainfleet
Wainwright Dr	Wainwright
Wakefield Rd	Wakefield
Walcott Pl	Walcott
Waldor Dr	Waldor
Walker St	Walker
Wallace St	Wallace
Wallowa Rd	Wallowa
Wall St	Wall
Walmsley Blvd	Walmsley
Walmsley Blvd Exd	Walmsley
Walnut Aly	Walnut
Walnut Ave	Walnut
Walpole St	Walpole
Walton Ave	Walton
Warner Rd	Warner
Warren Ave	Warren
Warwick Ave	Warwick
Warwick Rd	Warwick
Warwick Village Dr	Warwick Village
Washington St	Washington
Water St	Water
Watkins St	Watkins
Watson Ave	Watson
Waumsetta Rd	Waumsetta
Waverly Ave	Waverly
Waxford Rd	Waxford
Wayland St	Wayland
Wayne St	Wayne
W Bacon St	Bacon
W Baker St	Baker
W Belmont Rd	Belmont
W Blake Ln	Blake
W Bostwick Ln	Bostwick
W Broad Rock Rd	Broad
W Broad St	Broad
W Brookland Park Blvd	Brookland
W Canal St	Canal
W Carnation St	Carnation
W Cary St	Cary
W Catherine St	Catherine
W Charity St	Charity
W Clay St	Clay
W Clopton St	Clopton
W Commerce Rd	Commerce
W Coutts St	Coutts
W Crawford St	Crawford
W Crieff Rd	Crieff
W Duval St	Duval
Weatherford Rd	Weatherford
Weaver Ct	Weaver
Webber Ave	Webber
Webster St	Webster
Welford Ave	Welford
Wellford St	Wellford
Wellington St	Wellington
Welton Ave	Welton
Wendell Ln	Wendell
Wentbridge Rd	Wentbridge
Wesley Rd	Wesley
Wessex Ln	Wessex
W Essex St	Essex
West Ave	West
Westbrook Ave	Westbrook
Westchester Cir	Westchester
Westchester Rd	Westchester
Westcott Dr	Westcott
Westgate Dr	Westgate
Westhampton Way	Westhampton
Westlake Ave	Westlake
Westminster Ave	Westminster
Westminster Canterbury Way	Westminster Canterbury
Westmoreland St	Westmoreland
Westover Gardens Blvd	Westover Gardens
Westover Hills Blvd	Westover Hills
Westover Rd	Westover
Westover Village Dr	Westover Village
Westover Woods Cir	Westover Woods
Westower Ct	Westower
Westower Dr	Westower
Westview Ave	Westview
Westwick Dr	Westwick
Westwood Ave	Westwood
Wexford Ln	Wexford
Weymouth Dr	Weymouth
W Federal St	Federal
W Fells St	Fells
W Franklin St	Franklin
W Fritz St	Fritz
W Gladstone Ave	Gladstone
W Grace St	Grace
W Graham Rd	Graham
Wharton Rd	Wharton
Wheaton Rd	Wheaton
W Hillcrest Ave	Hillcrest
Whitby Rd	Whitby
Whitcomb St	Whitcomb
Whitehall Rd	Whitehall
Whitehead Rd	Whitehead
Whitehorse Rd	Whitehorse
White Oak Dr	White
Whitesand Dr	Whitesand
Whitewood Rd	Whitewood
Whitlone Dr	Whitlone
W Home St	Home
W Hooper St	Hooper
W Huguenot Rd	Huguenot
Wickham St	Wickham
Wighton Dr	Wighton
Wilbon St	Wilbon
Willamar St	Willamar
Willetta Dr	Willetta
Williamsburg Ave	Williamsburg
Williamsburg Rd	Williamsburg
Willis Rd	Willis
Willoughby Ct	Willoughby
Willow Creek Ln	Creek
Willow Creek Way	Creek
Willow Lawn Dr	Lawn
Willow Oaks Dr	Oaks
Willway Ave	Willway
Wilmington Ave	Wilmington
Winber Dr	Winber
Winchell St	Winchell
Windcroft Rd	Windcroft
Winder St	Winder
Windmoor Ct	Windmoor
Windsor Ave	Windsor
Windsorview Dr	Windsorview
Windsor Way	Windsor
Winford Ln	Winford
Wingfield St	Wingfield
Winter Rd	Winter
Wise St	Wise
Wisteria Ave	Wisteria
W Jackson St	Jackson
W Junaluska Dr	Junaluska
W Laburnum Ave	Laburnum
W Ladies Mile Rd	Ladies Mile
W Lancaster Rd	Lancaster
W Leigh St	Leigh
W Locke Ln	Locke
W Main St	Main
W Marshall St	Marshall
W Martin's Grant Cir	Martin' Grant
W Meredith St	Meredith
W Moore St	Moore
W Norwood Ave	Norwood
Woodberry Ln	Woodberry
Woodbine Rd	Woodbine
Woodburn Ct	Woodburn
Woodburn Rd	Woodburn
Woodcliff Ave	Woodcliff
Woodhaven Dr	Woodhaven
Woodlawn Ave	Woodlawn
Woodmere Dr	Woodmere
Woodrow Ave	Woodrow
Woodson Ave	Woodson
Wood St	Wood
Woodstock Rd	Woodstock
Woodys Ct	Woodys
Woodys Ln	Woodys
Worsham Way	Worsham
Worthington Ct	Worthington
Worthington Rd	Worthington
Worth St	Worth
W Pilkington St	Pilkington
W Point Ct	Point
Wright Ave	Wright
W Roanoke St	Roanoke
W Roberts St	Roberts
W Seminary Ave	Seminary
W Southside Plz	Southside Plz
W Tremont Ct	Tremont
W Weyburn Rd	Weyburn
Wyandotte Dr	Wyandotte
Wyck St	Wyck
Wyncliff Dr	Wyncliff
Wythe Ave	Wythe
Wythemar St	Wythemar
Yale Ave	Yale
Yancey St	Yancey
Yeardley Dr	Yeardley
Yellowpine Cir	Yellowpine
Yellowpine Dr	Yellowpine
York Rd	York
Yorkshire Dr	Yorkshire
Yorktown Ave	Yorktown
Young St	Young
Yukon Rd	Yukon
Yuma Rd	Yuma
Zion St	Zion
Zurich Dr	Zurich
